11111111111111111111
10000000000000000001
10000000000000000001
10011000000000000001
10010000000000000001
10000000000000000001
10000000000000000001
10000011100000000001
10000000000000000001
10000000000000000001
10000000000001100001
10000000000000100001
10000000000000000001
10000000000000000001
11111111111111111111