11111111111111111111
10000000000000000001
10000000000000000001
10000000000000000001
10000000000000000001
10000001111000000001
10000000000000000001
10000000000000000001
11110000000000001111
10000000000000000001
10000000000000000001
10001111000011110001
10000000000000000001
10000000000000000001
11111111111111111111